3 10
9 0
5 8
8 1
  5 63  8 18 53 34 20  4  3  3
 57 46  1 23 45 45 32  4  5  3
 63 38  8 25 54  1 48 55  1  5
 64 34  5 24 46  3 29 61  2  7
 64 37  7 20 36 50  3 57  3  8
 63 38 15 10 24 38 29 57  4  7
 61 38 19  1 15 28 32 42  2  4
 24 25 18  2 12 22 31 47  2  7
  9 14 16  8  3 12 19 25 11  5
  5 10 12  9  4  8 10 11  9  5
