2 9
7 1
7 0
  3 63 20  5 14 24 22  4  6
 59 51 28 17 33 49 62 76  2
 58 48 35 23 48 68 89  5  4
 64 44 26 48 72 88 49  5  4
 59 37 24 63 89 62  3  8  5
 63 22 38 82 60 44  4  7  8
 26  5 36 80 46 30  1  3  8
 10  7 15 33  1 14  7  5  4
  3  4  7 15  4  9  9  8  4
