5 10
5 5
2 0
2 6
9 0
1 3
  4 37 26 22  4  9  8  9 21  4
  1 21 37 44 30 21  4 10 16  6
  4  3 37 82 56 31  5  7  9  6
  8  3 27 61 79 35 15  4  7  6
  9  8  2 41 57 79 17 12  3  6
 10  7  4 30 41 65 74 20  4  4
 11  4 11 22  4 34 17 76  5  5
 21 11  9  1  6 22 19 36  1  4
 12 12  5  5  8 14 16 21  3  3
  7  8  8  5  4  8 10 10  4  3
